1111111111111111111111111111111
1000000000000000000000000000001
1000000000000000000000000000001
1000000000000000000000000000001
1000011111111111111110000000001
1000010000000000000000000000001
1000010000111111111111111111111
1000010000100000000000000000001
1000010000100000000000000000001
1110010000100000000000000000001
1010010000100000000000000000001
1010010000100000000000000000001
0010010000000000000000000000001
1010010001111111111110110110001
1000010001000000000000000000001
1000110001000000000000000000001
1111111111111111111111110111111