1111111111111111111111111111111111111111111111111111111111111111111111111111111111111111111111
0000000011100101000000011000000100000000100110000000010001101001011000011000001010100001011001
1001100000001110000100101010001010000000000110000100101010000000000111101000000100000000101001
1000110001000010010000100000010000000010010100000111000001100100010000001011100000000010010001
1001000000100100101011100101001001110110110100000000100011101000001001001000010000001100001111
1101001101000010100000001000100110000110000000010000100100110001010110100010000000000100110001
1000001100010010000010100000010000000011110101010100001000010000011100001110011001001000001111
1000011100001000010001001100001000000000000010100100010000000000100000000000001010100010001111
1001000001000011100000110100001000010001100001001100000000010000000001001000010100000100011011
1010011010011110100100110001000011101000000001010000000000000000000001000000010110110000100101
1000111010000010000000100010011011000000010000000111010001010111010000100100000110001101000001
1000010101100000000100000000110011010000000111101000000100100000000011000110000001000000010011
1000000100100010000100000000000100100010010000010101010011011000011010010000000111001001000001
1000111110111010110011000000110101000000000100000000000000001000000011101000100001000101001111
1001001101001001000011000000100100000000000110011010100101010000101001000001100000010000010001
1000000000010000000001010010100101100101011001011101101000111001100000000100010000010001000001
1110100101000000001000000100000000111011001001001000100000000011000000010010110000111101110001
1010000110100100010000000100010001000001001000110010001010010011011110000011000000101000101011
1010010010000101000000010100110000111101101010110100010100000111100000000101101100010001000111
1001000100000011100100111010001111001100001101000010100000000000000100011100101010010000000011
1110110000000000001000000000000000100000000000011011100100101001000000000011000010100010010101
1010000000101010000000000001000001010111110000000000001000110001000011100000000111101100000101
1011010100000101011100100000001000000000010000100000000000101001101100100010011100000101010001
1110000101001010001000111000100000100010100010010000001000100100001101110001100000000000000001
1010000001010001011010111001001011000110100001101011110011011010110010001001001100010100000001
1001001001001100000000100001000010000011001000010001100001000110011111100000001000000010000111
1001000000011010010000011110000000110100000000000111100001000101001011001000010010110011001101
1101110101010010000101110000010100011000110000110110001011011111100000100100001001000010110011
1100111110100000010100000010001011010100001000000000000010011010001000000100001001101000101001
1000001011011011010111000000101100101010011011000110100110100100110000100000000010000000001011
1100101100101011000011010010011000000010001000010010100000010010001001100100001100000101000001
1001010000000000000010000010000011011001010000000100010001010101001001000000001101000001100011
1100010000110000001000101110100010010000110001100010001000000000000001001100100000000011001001
1110001000010000100010100001000000000000100100010100010000111001001110000101000000100111000001
1100000000001100110000111000010011000100011000010000100000001000100100001100100110000000000101
1001100100011010001010000011010010001100001110001101000001101110011101111011100100110000011001
1001000000010101000000101000110100000001011000011010001001010001000101100010000100001000000011
1000001000101001011101001001000010000111000111101011101000010101010100001010001011100100011001
1000111101001000100000110101010110010100000011000000000000011100110110000101011000100000000011
1111001000010001001000000000010110010000000101100000111010001000011000110101010011000000001001
1000011001101010000010011001111000101000000010111001000110011011010000000000100100100001000100
1111111111111111111111111111111111111111111111111111111111111111111111111111111111111111111111
